1111111111111111111111111111111111
1E0000000000000C00000C0000000000E1
1010010100100000101001000000010111
1010010010101010001001000000010101
100000000C00C0000000000000000000C1
1P0000000C00C0000000000000000000C1
100000000C00C0000000000000000000C1
100000000C00C0000000000000000000C1
100000000C00C0000000010000000000C1
100000000C00C000000000000000000C11
100000000C00C0000000000000000000C1
1111111111111111111111111111111111