1111111111111111111
11P000000C000000111
100000000C00C000001
100000000C000000111
100000000C00C000001
100000000C00C000001
100000000C00C000001
100000000C00C00E001
1111111111111111111
