1111111111111111
111111110C111111
1111111100000001
111111P111000001
111111000000CCC1
111E000000CC1111
1111111111111111
