1111111
1111111
1111P11
1110011
111C111
111E111
1111111
